NO textures/wall_1.xpm
SO textures/wall_2.xpm
WE textures/wall_3.xpm
EA textures/wall_4.xpm

F 184,113,39
C 51,198,227

1111111111111111111111111111
1000000000011000000000000001
1011000001110000000000000011
1001000000000000000000000011
1011000001110000000000000011
1000000000011000001110111111
1111011111111101110000000011
1111011111111101110100000011
1100000110101111000000000011
1000000000000000110000000011
1000000000000000110001000001
1100000110101000000000000011
1111011111101010000000000011
1000000000110000100000000011
1000000000000000000000000111
1000000000010000100000000111
100000000011010000000N000011
1000000000010000000001000111
1111111111111111111111111111
