NO textures/sky_1.xpm
SO textures/sky_1.xpm
WE textures/sky_1.xpm
EA textures/sky_1.xpm

F 184,113,39
C 51,198,227

1111111111111111111111111111
1S00000000111110000000000001
1011111100000011111101111101
1000000111111010000100000001
1111100000011010111110111101
1000111100011010000000100001
1011100011111001111101111101
1000000010000000000000000001
1111111010111110111110111111
1000000010000100000000000001
1011111111110101111111111101
1000000000000100000000000001
1011111111101111111111101101
1000000000000000000000000001
1111111111111111111111111111
